Date,Vaccinated (daily),Vaccinated (cumu),Vaccinated population percentage,Second dose (daily),Second dose (cumu),Second dose population precentage,Third dose (daily),Third dose (cumu),Third dose population precentage
2020-12-19,45,62,0,0,0,0,0,0,0
2020-12-20,7382,7444,0.08,0,0,0,0,0,0
2020-12-21,24898,32342,0.35,0,0,0,0,0,0
2020-12-22,44629,76971,0.83,0,0,0,0,0,0
2020-12-23,62869,139840,1.5,0,0,0,0,0,0
2020-12-24,73375,213215,2.29,0,0,0,0,0,0
2020-12-25,38477,251692,2.71,0,0,0,0,0,0
2020-12-26,32598,284290,3.06,0,0,0,0,0,0
2020-12-27,104462,388752,4.18,0,0,0,0,0,0
2020-12-28,134917,523669,5.63,0,0,0,0,0,0
2020-12-29,156151,679820,7.31,0,0,0,0,0,0
2020-12-30,152957,832777,8.96,0,0,0,0,0,0
2020-12-31,158396,991173,10.66,0,0,0,0,0,0
2021-01-01,71328,1062501,11.43,0,0,0,0,0,0
2021-01-02,71670,1134171,12.2,0,0,0,0,0,0
2021-01-03,149576,1283747,13.8,0,0,0,0,0,0
2021-01-04,152026,1435773,15.44,1,1,0,0,0,0
2021-01-05,125023,1560796,16.78,0,1,0,0,0,0
2021-01-06,103203,1663999,17.89,1,2,0,0,0,0
2021-01-07,115936,1779935,19.14,5,7,0,0,0,0
2021-01-08,66379,1846314,19.85,3,10,0,0,0,0
2021-01-09,44490,1890804,20.33,23,33,0,0,0,0
2021-01-10,37579,1928383,20.74,5990,6023,0.06,0,0,0
2021-01-11,21079,1949462,20.96,19244,25267,0.27,0,0,0
2021-01-12,23965,1973427,21.22,35644,60911,0.66,0,0,0
2021-01-13,51973,2025400,21.78,56841,117752,1.27,0,0,0
2021-01-14,56366,2081766,22.39,68797,186549,2.01,0,0,0
2021-01-15,30679,2112445,22.72,35903,222452,2.39,0,0,0
2021-01-16,29406,2141851,23.03,25995,248447,2.67,0,0,0
2021-01-17,68332,2210183,23.77,84530,332977,3.58,0,0,0
2021-01-18,69632,2279815,24.52,120334,453311,4.87,0,0,0
2021-01-19,72727,2352542,25.3,137705,591016,6.36,0,0,0
2021-01-20,76690,2429232,26.12,143609,734625,7.9,0,0,0
2021-01-21,69809,2499041,26.87,164244,898869,9.67,0,0,0
2021-01-22,37793,2536834,27.28,71031,969900,10.43,0,0,0
2021-01-23,39898,2576732,27.71,53521,1023421,11.01,0,0,0
2021-01-24,68999,2645731,28.45,140540,1163961,12.52,0,0,0
2021-01-25,80793,2726524,29.32,139361,1303322,14.02,0,0,0
2021-01-26,78568,2805092,30.16,126261,1429583,15.37,0,0,0
2021-01-27,77789,2882881,31,124893,1554476,16.72,0,0,0
2021-01-28,79419,2962300,31.86,130467,1684943,18.12,0,0,0
2021-01-29,36570,2998870,32.25,64712,1749655,18.81,0,0,0
2021-01-30,34339,3033209,32.62,42703,1792358,19.27,0,0,0
2021-01-31,73219,3106428,33.41,59412,1851770,19.91,0,0,0
2021-02-01,82383,3188811,34.29,35273,1887043,20.29,0,0,0
2021-02-02,69941,3258752,35.04,30997,1918040,20.63,0,0,0
2021-02-03,60143,3318895,35.69,51330,1969370,21.18,0,0,0
2021-02-04,72484,3391379,36.47,58003,2027373,21.8,0,0,0
2021-02-05,33830,3425209,36.83,28715,2056088,22.11,0,0,0
2021-02-06,21562,3446771,37.06,22178,2078266,22.35,0,0,0
2021-02-07,53995,3500766,37.65,68618,2146884,23.09,0,0,0
2021-02-08,58534,3559300,38.27,65314,2212198,23.79,0,0,0
2021-02-09,66222,3625522,38.99,67432,2279630,24.51,0,0,0
2021-02-10,70404,3695926,39.74,72128,2351758,25.29,0,0,0
2021-02-11,81008,3776934,40.62,71943,2423701,26.06,0,0,0
2021-02-12,38992,3815926,41.03,37494,2461195,26.47,0,0,0
2021-02-13,27393,3843319,41.33,30382,2491577,26.79,0,0,0
2021-02-14,74793,3918112,42.13,68954,2560531,27.53,0,0,0
2021-02-15,81390,3999502,43.01,75581,2636112,28.35,0,0,0
2021-02-16,83317,4082819,43.9,78148,2714260,29.19,0,0,0
2021-02-17,61857,4144676,44.57,75479,2789739,30,0,0,0
2021-02-18,69027,4213703,45.31,79613,2869352,30.86,0,0,0
2021-02-19,39579,4253282,45.74,38054,2907406,31.26,0,0,0
2021-02-20,31592,4284874,46.08,28681,2936087,31.57,0,0,0
2021-02-21,79332,4364206,46.93,78331,3014418,32.42,0,0,0
2021-02-22,84937,4449143,47.84,80474,3094892,33.28,0,0,0
2021-02-23,77215,4526358,48.67,70334,3165226,34.04,0,0,0
2021-02-24,60944,4587302,49.33,62970,3228196,34.71,0,0,0
2021-02-25,51599,4638901,49.88,64667,3292863,35.41,0,0,0
2021-02-26,25800,4664701,50.16,31940,3324803,35.75,0,0,0
2021-02-27,18280,4682981,50.36,21160,3345963,35.98,0,0,0
2021-02-28,40217,4723198,50.79,55798,3401761,36.58,0,0,0
2021-03-01,45563,4768761,51.28,61325,3463086,37.24,0,0,0
2021-03-02,41051,4809812,51.72,64648,3527734,37.94,0,0,0
2021-03-03,41866,4851678,52.17,66649,3594383,38.65,0,0,0
2021-03-04,39533,4891211,52.6,78968,3673351,39.5,0,0,0
2021-03-05,17204,4908415,52.78,40365,3713716,39.94,0,0,0
2021-03-06,10606,4919021,52.9,25298,3739014,40.21,0,0,0
2021-03-07,31022,4950043,53.23,72748,3811762,40.99,0,0,0
2021-03-08,27210,4977253,53.52,73166,3884928,41.78,0,0,0
2021-03-09,26587,5003840,53.81,76495,3961423,42.6,0,0,0
2021-03-10,23173,5027013,54.06,58565,4019988,43.23,0,0,0
2021-03-11,23115,5050128,54.31,68949,4088937,43.97,0,0,0
2021-03-12,11142,5061270,54.43,41328,4130265,44.41,0,0,0
2021-03-13,7870,5069140,54.51,25192,4155457,44.69,0,0,0
2021-03-14,20855,5089995,54.74,73859,4229316,45.48,0,0,0
2021-03-15,19958,5109953,54.95,78148,4307464,46.32,0,0,0
2021-03-16,18592,5128545,55.15,71392,4378856,47.09,0,0,0
2021-03-17,17547,5146092,55.34,58915,4437771,47.72,0,0,0
2021-03-18,15873,5161965,55.51,58026,4495797,48.35,0,0,0
2021-03-19,6790,5168755,55.58,27900,4523697,48.65,0,0,0
2021-03-20,5138,5173893,55.64,15255,4538952,48.81,0,0,0
2021-03-21,13066,5186959,55.78,40412,4579364,49.24,0,0,0
2021-03-22,13405,5200364,55.92,40426,4619790,49.68,0,0,0
2021-03-23,2651,5203015,55.95,7195,4626985,49.76,0,0,0
2021-03-24,10831,5213846,56.07,46432,4673417,50.26,0,0,0
2021-03-25,10081,5223927,56.18,35314,4708731,50.64,0,0,0
2021-03-26,4040,5227967,56.22,13249,4721980,50.78,0,0,0
2021-03-27,1720,5229687,56.24,4219,4726199,50.82,0,0,0
2021-03-28,2051,5231738,56.26,4564,4730763,50.87,0,0,0
2021-03-29,6793,5238531,56.33,29920,4760683,51.19,0,0,0
2021-03-30,7697,5246228,56.42,22305,4782988,51.43,0,0,0
2021-03-31,7997,5254225,56.5,19334,4802322,51.64,0,0,0
2021-04-01,7990,5262215,56.59,18546,4820868,51.84,0,0,0
2021-04-02,2807,5265022,56.62,8023,4828891,51.93,0,0,0
2021-04-03,1356,5266378,56.63,2904,4831795,51.96,0,0,0
2021-04-04,9554,5275932,56.73,22763,4854558,52.2,0,0,0
2021-04-05,10204,5286136,56.84,21137,4875695,52.43,0,0,0
2021-04-06,8816,5294952,56.94,16615,4892310,52.61,0,0,0
2021-04-07,8716,5303668,57.03,15143,4907453,52.77,0,0,0
2021-04-08,9194,5312862,57.13,16844,4924297,52.95,0,0,0
2021-04-09,3406,5316268,57.17,6095,4930392,53.02,0,0,0
2021-04-10,1519,5317787,57.18,3456,4933848,53.06,0,0,0
2021-04-11,8912,5326699,57.28,14138,4947986,53.21,0,0,0
2021-04-12,8730,5335429,57.37,13076,4961062,53.35,0,0,0
2021-04-13,5635,5341064,57.44,4823,4965885,53.4,0,0,0
2021-04-14,3449,5344513,57.47,5161,4971046,53.46,0,0,0
2021-04-15,477,5344990,57.48,458,4971504,53.46,0,0,0
2021-04-16,3223,5348213,57.51,6501,4978005,53.53,0,0,0
2021-04-17,751,5348964,57.52,1930,4979935,53.55,0,0,0
2021-04-18,6980,5355944,57.6,7375,4987310,53.63,0,0,0
2021-04-19,6232,5362176,57.66,7003,4994313,53.71,0,0,0
2021-04-20,6073,5368249,57.73,6738,5001051,53.78,0,0,0
2021-04-21,6169,5374418,57.79,6948,5007999,53.85,0,0,0
2021-04-22,5772,5380190,57.86,7513,5015512,53.93,0,0,0
2021-04-23,2602,5382792,57.88,3258,5018770,53.97,0,0,0
2021-04-24,688,5383480,57.89,1225,5019995,53.98,0,0,0
2021-04-25,4723,5388203,57.94,6844,5026839,54.06,0,0,0
2021-04-26,5343,5393546,58,7758,5034597,54.14,0,0,0
2021-04-27,4363,5397909,58.05,6456,5041053,54.21,0,0,0
2021-04-28,4325,5402234,58.09,7146,5048199,54.29,0,0,0
2021-04-29,4209,5406443,58.14,7134,5055333,54.36,0,0,0
2021-04-30,1758,5408201,58.16,3045,5058378,54.4,0,0,0
2021-05-01,390,5408591,58.16,833,5059211,54.4,0,0,0
2021-05-02,3157,5411748,58.2,5978,5065189,54.47,0,0,0
2021-05-03,3409,5415157,58.23,5655,5070844,54.53,0,0,0
2021-05-04,3405,5418562,58.27,4557,5075401,54.58,0,0,0
2021-05-05,3130,5421692,58.3,3900,5079301,54.62,0,0,0
2021-05-06,3460,5425152,58.34,2954,5082255,54.65,0,0,0
2021-05-07,1676,5426828,58.36,2320,5084575,54.68,0,0,0
2021-05-08,180,5427008,58.36,436,5085011,54.68,0,0,0
2021-05-09,2765,5429773,58.39,4647,5089658,54.73,0,0,0
2021-05-10,2771,5432544,58.42,4550,5094208,54.78,0,0,0
2021-05-11,2441,5434985,58.45,3670,5097878,54.82,0,0,0
2021-05-12,1834,5436819,58.46,3124,5101002,54.85,0,0,0
2021-05-13,1831,5438650,58.48,3512,5104514,54.89,0,0,0
2021-05-14,789,5439439,58.49,1350,5105864,54.91,0,0,0
2021-05-15,144,5439583,58.49,185,5106049,54.91,0,0,0
2021-05-16,437,5440020,58.5,1145,5107194,54.92,0,0,0
2021-05-17,195,5440215,58.5,763,5107957,54.93,0,0,0
2021-05-18,1830,5442045,58.52,4819,5112776,54.98,0,0,0
2021-05-19,2052,5444097,58.54,4890,5117666,55.03,0,0,0
2021-05-20,2124,5446221,58.57,3737,5121403,55.07,0,0,0
2021-05-21,1029,5447250,58.58,1246,5122649,55.09,0,0,0
2021-05-22,148,5447398,58.58,326,5122975,55.09,0,0,0
2021-05-23,2202,5449600,58.6,3136,5126111,55.12,0,0,0
2021-05-24,1987,5451587,58.62,3479,5129590,55.16,0,0,0
2021-05-25,1660,5453247,58.64,2457,5132047,55.19,0,0,0
2021-05-26,1245,5454492,58.65,2357,5134404,55.21,0,0,0
2021-05-27,1669,5456161,58.67,2974,5137378,55.24,0,0,0
2021-05-28,641,5456802,58.68,1260,5138638,55.26,0,0,0
2021-05-29,109,5456911,58.68,166,5138804,55.26,0,0,0
2021-05-30,1553,5458464,58.7,1853,5140657,55.28,0,0,0
2021-05-31,1580,5460044,58.71,1986,5142643,55.3,0,0,0
2021-06-01,1202,5461246,58.73,1709,5144352,55.32,0,0,0
2021-06-02,1333,5462579,58.74,1467,5145819,55.34,0,0,0
2021-06-03,1529,5464108,58.76,1313,5147132,55.35,0,0,0
2021-06-04,937,5465045,58.77,568,5147700,55.36,0,0,0
2021-06-05,115,5465160,58.77,74,5147774,55.36,0,0,0
2021-06-06,4198,5469358,58.81,884,5148658,55.37,0,0,0
2021-06-07,4253,5473611,58.86,682,5149340,55.37,0,0,0
2021-06-08,3595,5477206,58.9,1042,5150382,55.38,0,0,0
2021-06-09,3467,5480673,58.94,1168,5151550,55.4,0,0,0
2021-06-10,3200,5483873,58.97,1144,5152694,55.41,0,0,0
2021-06-11,1256,5485129,58.98,422,5153116,55.41,0,0,0
2021-06-12,145,5485274,58.99,93,5153209,55.42,0,0,0
2021-06-13,3049,5488323,59.02,1173,5154382,55.43,0,0,0
2021-06-14,2915,5491238,59.05,1391,5155773,55.44,0,0,0
2021-06-15,2987,5494225,59.08,1214,5156987,55.46,0,0,0
2021-06-16,2599,5496824,59.11,851,5157838,55.46,0,0,0
2021-06-17,2575,5499399,59.14,1045,5158883,55.48,0,0,0
2021-06-18,1131,5500530,59.15,357,5159240,55.48,0,0,0
2021-06-19,147,5500677,59.15,79,5159319,55.48,0,0,0
2021-06-20,3244,5503921,59.19,1230,5160549,55.49,0,0,0
2021-06-21,5076,5508997,59.24,1079,5161628,55.51,0,0,0
2021-06-22,6775,5515772,59.31,952,5162580,55.52,0,0,0
2021-06-23,10567,5526339,59.43,1141,5163721,55.53,0,0,0
2021-06-24,11871,5538210,59.56,1327,5165048,55.54,0,0,0
2021-06-25,6944,5545154,59.63,781,5165829,55.55,0,0,0
2021-06-26,2195,5547349,59.65,117,5165946,55.55,0,0,0
2021-06-27,13539,5560888,59.8,3354,5169300,55.59,0,0,0
2021-06-28,14365,5575253,59.95,3533,5172833,55.63,0,0,0
2021-06-29,16552,5591805,60.13,3571,5176404,55.66,0,0,0
2021-06-30,16305,5608110,60.31,3223,5179627,55.7,0,0,0
2021-07-01,16669,5624779,60.49,3231,5182858,55.73,18,18,0
2021-07-02,9694,5634473,60.59,1435,5184293,55.75,0,18,0
2021-07-03,2602,5637075,60.62,245,5184538,55.75,0,18,0
2021-07-04,17663,5654738,60.81,3088,5187626,55.79,0,18,0
2021-07-05,17725,5672463,61,2891,5190517,55.82,2,20,0
2021-07-06,17737,5690200,61.19,3244,5193761,55.85,5,25,0
2021-07-07,15375,5705575,61.35,2536,5196297,55.88,9,34,0
2021-07-08,16452,5722027,61.53,2703,5199000,55.91,11,45,0
2021-07-09,11034,5733061,61.65,1341,5200341,55.92,0,45,0
2021-07-10,4900,5737961,61.7,309,5200650,55.93,2,47,0
2021-07-11,1394,5739355,61.72,2774,5203424,55.96,1,48,0
2021-07-12,2328,5741683,61.74,3531,5206955,55.99,44,92,0
2021-07-13,2856,5744539,61.77,5299,5212254,56.05,117,209,0
2021-07-14,2620,5747159,61.8,7369,5219623,56.13,438,647,0.01
2021-07-15,2867,5750026,61.83,9112,5228735,56.23,368,1015,0.01
2021-07-16,1162,5751188,61.85,5751,5234486,56.29,62,1077,0.01
2021-07-17,299,5751487,61.85,1307,5235793,56.3,5,1082,0.01
2021-07-18,2009,5753496,61.87,9690,5245483,56.41,233,1315,0.01
2021-07-19,3100,5756596,61.9,11169,5256652,56.53,453,1768,0.02
2021-07-20,2550,5759146,61.93,11759,5268411,56.65,365,2133,0.02
2021-07-21,2273,5761419,61.96,11694,5280105,56.78,318,2451,0.03
2021-07-22,2798,5764217,61.99,13087,5293192,56.92,382,2833,0.03
2021-07-23,1929,5766146,62.01,8063,5301255,57.01,95,2928,0.03
2021-07-24,575,5766721,62.01,1395,5302650,57.02,5,2933,0.03
2021-07-25,4352,5771073,62.06,15398,5318048,57.19,213,3146,0.03
2021-07-26,5053,5776126,62.11,13352,5331400,57.33,315,3461,0.04
2021-07-27,5396,5781522,62.17,13396,5344796,57.48,407,3868,0.04
2021-07-28,3899,5785421,62.21,12196,5356992,57.61,453,4321,0.05
2021-07-29,4571,5789992,62.26,13984,5370976,57.76,514,4835,0.05
2021-07-30,2547,5792539,62.29,10702,5381678,57.87,4104,8939,0.1
2021-07-31,1362,5793901,62.3,3480,5385158,57.91,6146,15085,0.16
2021-08-01,3023,5796924,62.34,3286,5388444,57.94,31010,46095,0.5
2021-08-02,3036,5799960,62.37,3035,5391479,57.98,58453,104548,1.12
2021-08-03,3299,5803259,62.41,3172,5394651,58.01,78890,183438,1.97
2021-08-04,3464,5806723,62.44,3092,5397743,58.04,80682,264120,2.84
2021-08-05,4424,5811147,62.49,3450,5401193,58.08,88351,352471,3.79
2021-08-06,2359,5813506,62.52,1707,5402900,58.1,44694,397165,4.27
2021-08-07,979,5814485,62.53,603,5403503,58.11,27313,424478,4.56
2021-08-08,4989,5819474,62.58,3007,5406510,58.14,79985,504463,5.42
2021-08-09,5294,5824768,62.64,2918,5409428,58.17,76397,580860,6.25
2021-08-10,5517,5830285,62.7,3061,5412489,58.2,75310,656170,7.06
2021-08-11,5620,5835905,62.76,2819,5415308,58.23,62544,718714,7.73
2021-08-12,6984,5842889,62.83,3190,5418498,58.27,59369,778083,8.37
2021-08-13,3751,5846640,62.87,1954,5420452,58.29,43806,821889,8.84
2021-08-14,2234,5848874,62.9,763,5421215,58.3,44420,866309,9.32
2021-08-15,7165,5856039,62.97,4453,5425668,58.34,97838,964147,10.37
2021-08-16,6978,5863017,63.05,4614,5430282,58.39,89323,1053470,11.33
2021-08-17,7558,5870575,63.13,5026,5435308,58.45,83115,1136585,12.22
2021-08-18,8626,5879201,63.22,4502,5439810,58.5,69088,1205673,12.97
2021-08-19,10050,5889251,63.33,5124,5444934,58.55,65788,1271461,13.67
2021-08-20,4718,5893969,63.38,2703,5447637,58.58,60313,1331774,14.32
2021-08-21,3498,5897467,63.42,1494,5449131,58.6,50629,1382403,14.87
2021-08-22,9894,5907361,63.52,4760,5453891,58.65,104874,1487277,15.99
2021-08-23,11000,5918361,63.64,4327,5458218,58.7,93687,1580964,17
2021-08-24,11820,5930181,63.77,4606,5462824,58.74,98112,1679076,18.06
2021-08-25,9739,5939920,63.88,4364,5467188,58.79,99157,1778233,19.12
2021-08-26,10163,5950083,63.98,4960,5472148,58.84,100848,1879081,20.21
2021-08-27,4312,5954395,64.03,2688,5474836,58.87,56528,1935609,20.81
2021-08-28,3706,5958101,64.07,1426,5476262,58.89,33431,1969040,21.17
2021-08-29,10417,5968518,64.18,5883,5482145,58.95,79265,2048305,22.03
2021-08-30,12412,5980930,64.32,6907,5489052,59.03,115617,2163922,23.27
2021-08-31,12124,5993054,64.45,6409,5495461,59.1,114413,2278335,24.5
2021-09-01,9074,6002128,64.54,5907,5501368,59.16,111869,2390204,25.7
2021-09-02,8832,6010960,64.64,7073,5508441,59.24,111089,2501293,26.9
2021-09-03,3710,6014670,64.68,4009,5512450,59.28,58724,2560017,27.53
2021-09-04,2668,6017338,64.71,1959,5514409,59.3,29863,2589880,27.85
2021-09-05,7069,6024407,64.78,6410,5520819,59.37,72983,2662863,28.64
2021-09-06,2806,6027213,64.81,2617,5523436,59.4,22701,2685564,28.88
2021-09-07,1172,6028385,64.83,794,5524230,59.4,5343,2690907,28.94
2021-09-08,1362,6029747,64.84,1114,5525344,59.42,6557,2697464,29.01
2021-09-09,7161,6036908,64.92,12455,5537799,59.55,73510,2770974,29.8
2021-09-10,3240,6040148,64.95,4922,5542721,59.6,37792,2808766,30.2
2021-09-11,2113,6042261,64.98,2445,5545166,59.63,14739,2823505,30.36
2021-09-12,6175,6048436,65.04,8523,5553689,59.72,53907,2877412,30.94
2021-09-13,5721,6054157,65.1,8151,5561840,59.81,47677,2925089,31.45
2021-09-14,4989,6059146,65.16,7337,5569177,59.89,48632,2973721,31.98
2021-09-15,1726,6060872,65.18,2647,5571824,59.92,16604,2990325,32.16
2021-09-16,314,6061186,65.18,484,5572308,59.92,1713,2992038,32.17
2021-09-17,3693,6064879,65.22,6926,5579234,60,42747,3034785,32.63
2021-09-18,2249,6067128,65.24,2895,5582129,60.03,12740,3047525,32.77
2021-09-19,6046,6073174,65.31,10664,5592793,60.14,44099,3091624,33.25
2021-09-20,3228,6076402,65.34,4576,5597369,60.19,16581,3108205,33.42
2021-09-21,1305,6077707,65.36,1990,5599359,60.21,3395,3111600,33.46
2021-09-22,4279,6081986,65.4,7187,5606546,60.29,24915,3136515,33.73
2021-09-23,4414,6086400,65.45,5829,5612375,60.35,27657,3164172,34.03
2021-09-24,3189,6089589,65.48,4103,5616478,60.4,27589,3191761,34.32
2021-09-25,2078,6091667,65.51,2212,5618690,60.42,10360,3202121,34.43
2021-09-26,5667,6097334,65.57,5930,5624620,60.48,36113,3238234,34.82
2021-09-27,4689,6102023,65.62,4387,5629007,60.53,30313,3268547,35.15
2021-09-28,1445,6103468,65.63,1146,5630153,60.54,6159,3274706,35.21
2021-09-29,9710,6113178,65.74,8286,5638439,60.63,60068,3334774,35.86
2021-09-30,11083,6124261,65.86,8472,5646911,60.72,79334,3414108,36.71
2021-10-01,5154,6129415,65.91,3776,5650687,60.76,46300,3460408,37.21
2021-10-02,2876,6132291,65.94,2089,5652776,60.79,22328,3482736,37.45
2021-10-03,11780,6144071,66.07,7219,5659995,60.86,70471,3553207,38.21
2021-10-04,10353,6154424,66.18,6691,5666686,60.94,51640,3604847,38.76
2021-10-05,8477,6162901,66.27,5239,5671925,60.99,40226,3645073,39.2
2021-10-06,7647,6170548,66.36,4098,5676023,61.04,33793,3678866,39.56
2021-10-07,6986,6177534,66.43,3949,5679972,61.08,33777,3712643,39.92
2021-10-08,3106,6180640,66.46,2562,5682534,61.11,19050,3731693,40.13
2021-10-09,1333,6181973,66.48,1397,5683931,61.12,7366,3739059,40.21
2021-10-10,4660,6186633,66.53,3687,5687618,61.16,21361,3760420,40.44
2021-10-11,4202,6190835,66.57,2853,5690471,61.19,17084,3777504,40.62
2021-10-12,3841,6194676,66.61,2859,5693330,61.22,15177,3792681,40.78
2021-10-13,3284,6197960,66.65,2307,5695637,61.25,13369,3806050,40.93
2021-10-14,3603,6201563,66.69,2528,5698165,61.28,16337,3822387,41.1
2021-10-15,1482,6203045,66.7,1514,5699679,61.29,8859,3831246,41.2
2021-10-16,702,6203747,66.71,878,5700557,61.3,3958,3835204,41.24
2021-10-17,2817,6206564,66.74,2342,5702899,61.33,12639,3847843,41.38
2021-10-18,2216,6208780,66.77,1511,5704410,61.34,9893,3857736,41.48
2021-10-19,2165,6210945,66.79,1163,5705573,61.35,9153,3866889,41.58
2021-10-20,2126,6213071,66.81,2070,5707643,61.38,9868,3876757,41.69
2021-10-21,2691,6215762,66.84,2819,5710462,61.41,11910,3888667,41.82
2021-10-22,1115,6216877,66.85,1269,5711731,61.42,5600,3894267,41.88
2021-10-23,317,6217194,66.86,1012,5712743,61.43,1802,3896069,41.9
