Date,Vaccinated (daily),Vaccinated (cumu),Vaccinated population percentage,Second dose (daily),Second dose (cumu),Second dose population precentage
2020-12-19,43,60,0,0,0,0
2020-12-20,7374,7434,0.08,0,0,0
2020-12-21,24884,32318,0.35,0,0,0
2020-12-22,44615,76933,0.83,0,0,0
2020-12-23,62832,139765,1.5,0,0,0
2020-12-24,73330,213095,2.29,0,0,0
2020-12-25,38452,251547,2.71,0,0,0
2020-12-26,32573,284120,3.06,0,0,0
2020-12-27,104369,388489,4.18,0,0,0
2020-12-28,134808,523297,5.63,0,0,0
2020-12-29,155956,679253,7.3,0,0,0
2020-12-30,152728,831981,8.95,0,0,0
2020-12-31,158184,990165,10.65,0,0,0
2021-01-01,71234,1061399,11.41,0,0,0
2021-01-02,71626,1133025,12.18,0,0,0
2021-01-03,149407,1282432,13.79,0,0,0
2021-01-04,151841,1434273,15.42,1,1,0
2021-01-05,124860,1559133,16.77,0,1,0
2021-01-06,103074,1662207,17.87,0,1,0
2021-01-07,115827,1778034,19.12,4,5,0
2021-01-08,66294,1844328,19.83,3,8,0
2021-01-09,44456,1888784,20.31,22,30,0
2021-01-10,37540,1926324,20.71,5985,6015,0.06
2021-01-11,21013,1947337,20.94,19237,25252,0.27
2021-01-12,23907,1971244,21.2,35639,60891,0.65
2021-01-13,51920,2023164,21.76,56814,117705,1.27
2021-01-14,56302,2079466,22.36,68756,186461,2.01
2021-01-15,30617,2110083,22.69,35884,222345,2.39
2021-01-16,29366,2139449,23.01,25977,248322,2.67
2021-01-17,68253,2207702,23.74,84457,332779,3.58
2021-01-18,69525,2277227,24.49,120216,452995,4.87
2021-01-19,72580,2349807,25.27,137537,590532,6.35
2021-01-20,76537,2426344,26.09,143403,733935,7.89
2021-01-21,69581,2495925,26.84,163967,897902,9.66
2021-01-22,37712,2533637,27.25,70926,968828,10.42
2021-01-23,39854,2573491,27.67,53474,1022302,10.99
2021-01-24,68937,2642428,28.42,140343,1162645,12.5
2021-01-25,80735,2723163,29.28,139177,1301822,14
2021-01-26,78482,2801645,30.13,126073,1427895,15.35
2021-01-27,77694,2879339,30.96,124722,1552617,16.7
2021-01-28,79410,2958749,31.82,130299,1682916,18.1
2021-01-29,36524,2995273,32.21,64611,1747527,18.79
2021-01-30,34289,3029562,32.58,42663,1790190,19.25
2021-01-31,73179,3102741,33.37,59344,1849534,19.89
2021-02-01,82275,3185016,34.25,35210,1884744,20.27
2021-02-02,69864,3254880,35,30950,1915694,20.6
2021-02-03,60071,3314951,35.65,51272,1966966,21.15
2021-02-04,72389,3387340,36.43,57920,2024886,21.77
2021-02-05,33778,3421118,36.79,28658,2053544,22.08
2021-02-06,21535,3442653,37.02,22140,2075684,22.32
2021-02-07,53940,3496593,37.6,68545,2144229,23.06
2021-02-08,58480,3555073,38.23,65202,2209431,23.76
2021-02-09,66121,3621194,38.94,67282,2276713,24.48
2021-02-10,70338,3691532,39.7,71952,2348665,25.26
2021-02-11,80893,3772425,40.57,71533,2420198,26.03
2021-02-12,38937,3811362,40.99,37409,2457607,26.43
2021-02-13,27389,3838751,41.28,30351,2487958,26.75
2021-02-14,74730,3913481,42.08,68872,2556830,27.49
2021-02-15,81323,3994804,42.96,75491,2632321,28.31
2021-02-16,83319,4078123,43.85,78041,2710362,29.15
2021-02-17,61797,4139920,44.52,75339,2785701,29.96
2021-02-18,68978,4208898,45.26,79497,2865198,30.81
2021-02-19,39559,4248457,45.69,37996,2903194,31.22
2021-02-20,31583,4280040,46.03,28645,2931839,31.53
2021-02-21,79317,4359357,46.88,78344,3010183,32.37
2021-02-22,84878,4444235,47.79,80361,3090544,33.23
2021-02-23,77194,4521429,48.62,70230,3160774,33.99
2021-02-24,60876,4582305,49.28,62873,3223647,34.67
2021-02-25,51511,4633816,49.83,64544,3288191,35.36
2021-02-26,25753,4659569,50.11,31888,3320079,35.7
2021-02-27,18255,4677824,50.3,21128,3341207,35.93
2021-02-28,40166,4717990,50.73,55712,3396919,36.53
2021-03-01,45510,4763500,51.22,61266,3458185,37.19
2021-03-02,41006,4804506,51.67,64525,3522710,37.88
2021-03-03,41785,4846291,52.11,66561,3589271,38.6
2021-03-04,39475,4885766,52.54,78848,3668119,39.45
2021-03-05,17164,4902930,52.72,40321,3708440,39.88
2021-03-06,10568,4913498,52.84,25279,3733719,40.15
2021-03-07,30970,4944468,53.17,72680,3806399,40.93
2021-03-08,27162,4971630,53.46,73083,3879482,41.72
2021-03-09,26501,4998131,53.75,76477,3955959,42.54
2021-03-10,23089,5021220,54,58505,4014464,43.17
2021-03-11,23056,5044276,54.24,68889,4083353,43.91
2021-03-12,11096,5055372,54.36,41298,4124651,44.35
2021-03-13,7848,5063220,54.45,25182,4149833,44.63
2021-03-14,20828,5084048,54.67,73831,4223664,45.42
2021-03-15,19904,5103952,54.89,78056,4301720,46.26
2021-03-16,18532,5122484,55.08,71357,4373077,47.03
2021-03-17,17502,5139986,55.27,58831,4431908,47.66
2021-03-18,15824,5155810,55.44,57967,4489875,48.28
2021-03-19,6750,5162560,55.52,27871,4517746,48.58
2021-03-20,5118,5167678,55.57,15226,4532972,48.75
2021-03-21,13029,5180707,55.71,40364,4573336,49.18
2021-03-22,13353,5194060,55.85,40373,4613709,49.61
2021-03-23,2603,5196663,55.88,7155,4620864,49.69
2021-03-24,10792,5207455,56,46349,4667213,50.19
2021-03-25,10036,5217491,56.11,35254,4702467,50.57
2021-03-26,4006,5221497,56.15,13216,4715683,50.71
2021-03-27,1710,5223207,56.17,4200,4719883,50.76
2021-03-28,2039,5225246,56.19,4548,4724431,50.8
2021-03-29,6770,5232016,56.26,29864,4754295,51.13
2021-03-30,7658,5239674,56.34,22233,4776528,51.36
2021-03-31,7949,5247623,56.43,19250,4795778,51.57
2021-04-01,7943,5255566,56.52,18468,4814246,51.77
2021-04-02,2769,5258335,56.55,7964,4822210,51.86
2021-04-03,1339,5259674,56.56,2879,4825089,51.89
2021-04-04,9539,5269213,56.66,22719,4847808,52.13
2021-04-05,10173,5279386,56.77,21082,4868890,52.36
2021-04-06,8770,5288156,56.87,16556,4885446,52.54
2021-04-07,8673,5296829,56.96,15091,4900537,52.7
2021-04-08,9159,5305988,57.06,16752,4917289,52.88
2021-04-09,3371,5309359,57.09,6053,4923342,52.94
2021-04-10,1491,5310850,57.11,3429,4926771,52.98
2021-04-11,8893,5319743,57.21,14094,4940865,53.13
2021-04-12,8703,5328446,57.3,13024,4953889,53.27
2021-04-13,5602,5334048,57.36,4780,4958669,53.32
2021-04-14,3426,5337474,57.4,5110,4963779,53.38
2021-04-15,450,5337924,57.4,413,4964192,53.38
2021-04-16,3191,5341115,57.44,6459,4970651,53.45
2021-04-17,743,5341858,57.44,1912,4972563,53.47
2021-04-18,6965,5348823,57.52,7351,4979914,53.55
2021-04-19,6205,5355028,57.59,6970,4986884,53.63
2021-04-20,6045,5361073,57.65,6686,4993570,53.7
2021-04-21,6151,5367224,57.72,6901,5000471,53.77
2021-04-22,5742,5372966,57.78,7466,5007937,53.85
2021-04-23,2585,5375551,57.81,3232,5011169,53.89
2021-04-24,680,5376231,57.81,1212,5012381,53.9
2021-04-25,4716,5380947,57.86,6825,5019206,53.97
2021-04-26,5331,5386278,57.92,7725,5026931,54.06
2021-04-27,4348,5390626,57.97,6415,5033346,54.13
2021-04-28,4310,5394936,58.01,7096,5040442,54.2
2021-04-29,4191,5399127,58.06,7084,5047526,54.28
2021-04-30,1731,5400858,58.08,3001,5050527,54.31
2021-05-01,382,5401240,58.08,820,5051347,54.32
2021-05-02,3154,5404394,58.12,5953,5057300,54.38
2021-05-03,3400,5407794,58.15,5631,5062931,54.44
2021-05-04,3382,5411176,58.19,4530,5067461,54.49
2021-05-05,3110,5414286,58.22,3866,5071327,54.53
2021-05-06,3437,5417723,58.26,2922,5074249,54.57
2021-05-07,1661,5419384,58.28,2282,5076531,54.59
2021-05-08,175,5419559,58.28,423,5076954,54.6
2021-05-09,2766,5422325,58.31,4626,5081580,54.64
2021-05-10,2764,5425089,58.34,4524,5086104,54.69
2021-05-11,2414,5427503,58.36,3640,5089744,54.73
2021-05-12,1816,5429319,58.38,3095,5092839,54.77
2021-05-13,1817,5431136,58.4,3478,5096317,54.8
2021-05-14,773,5431909,58.41,1333,5097650,54.82
2021-05-15,134,5432043,58.41,173,5097823,54.82
2021-05-16,426,5432469,58.42,1136,5098959,54.83
2021-05-17,187,5432656,58.42,758,5099717,54.84
2021-05-18,1817,5434473,58.44,4800,5104517,54.89
2021-05-19,2030,5436503,58.46,4876,5109393,54.94
2021-05-20,2092,5438595,58.48,3717,5113110,54.98
2021-05-21,1009,5439604,58.49,1223,5114333,55
2021-05-22,139,5439743,58.5,323,5114656,55
2021-05-23,2198,5441941,58.52,3125,5117781,55.03
2021-05-24,1976,5443917,58.54,3462,5121243,55.07
2021-05-25,1651,5445568,58.56,2437,5123680,55.1
2021-05-26,1219,5446787,58.57,2324,5126004,55.12
2021-05-27,1634,5448421,58.59,2946,5128950,55.15
2021-05-28,616,5449037,58.6,1240,5130190,55.17
2021-05-29,104,5449141,58.6,161,5130351,55.17
2021-05-30,1544,5450685,58.61,1848,5132199,55.19
2021-05-31,1523,5452208,58.63,1948,5134147,55.21
2021-06-01,1178,5453386,58.64,1666,5135813,55.23
2021-06-02,1289,5454675,58.66,1435,5137248,55.24
2021-06-03,1504,5456179,58.67,1291,5138539,55.26
2021-06-04,926,5457105,58.68,546,5139085,55.26
2021-06-05,104,5457209,58.68,66,5139151,55.26
2021-06-06,4181,5461390,58.73,873,5140024,55.27
2021-06-07,4223,5465613,58.77,667,5140691,55.28
2021-06-08,3555,5469168,58.81,1019,5141710,55.29
2021-06-09,3456,5472624,58.85,1128,5142838,55.3
2021-06-10,3188,5475812,58.88,1122,5143960,55.32
2021-06-11,1241,5477053,58.9,406,5144366,55.32
2021-06-12,138,5477191,58.9,89,5144455,55.32
2021-06-13,3037,5480228,58.93,1165,5145620,55.33
2021-06-14,2887,5483115,58.96,1375,5146995,55.35
2021-06-15,2952,5486067,58.99,1182,5148177,55.36
2021-06-16,2561,5488628,59.02,831,5149008,55.37
2021-06-17,2548,5491176,59.05,1012,5150020,55.38
2021-06-18,1084,5492260,59.06,335,5150355,55.38
2021-06-19,142,5492402,59.06,78,5150433,55.39
2021-06-20,3227,5495629,59.1,1211,5151644,55.4
2021-06-21,5039,5500668,59.15,1056,5152700,55.41
2021-06-22,6752,5507420,59.22,908,5153608,55.42
2021-06-23,10546,5517966,59.34,1106,5154714,55.43
2021-06-24,11846,5529812,59.46,1305,5156019,55.45
2021-06-25,6918,5536730,59.54,768,5156787,55.45
2021-06-26,2188,5538918,59.56,112,5156899,55.45
2021-06-27,13529,5552447,59.71,3304,5160203,55.49
2021-06-28,14337,5566784,59.86,3476,5163679,55.53
2021-06-29,16509,5583293,60.04,3521,5167200,55.57
2021-06-30,16269,5599562,60.21,3192,5170392,55.6
2021-07-01,16684,5616246,60.39,3198,5173590,55.63
2021-07-02,9657,5625903,60.5,1403,5174993,55.65
2021-07-03,2589,5628492,60.53,238,5175231,55.65
2021-07-04,17624,5646116,60.72,3069,5178300,55.68
2021-07-05,17637,5663753,60.91,2870,5181170,55.72
2021-07-06,17696,5681449,61.1,3197,5184367,55.75
2021-07-07,15283,5696732,61.26,2500,5186867,55.78
2021-07-08,16384,5713116,61.44,2667,5189534,55.81
2021-07-09,10993,5724109,61.55,1306,5190840,55.82
2021-07-10,4880,5728989,61.61,303,5191143,55.82
2021-07-11,1384,5730373,61.62,2762,5193905,55.85
2021-07-12,2316,5732689,61.65,3498,5197403,55.89
2021-07-13,2843,5735532,61.68,5254,5202657,55.95
2021-07-14,2602,5738134,61.71,7323,5209980,56.03
2021-07-15,2857,5740991,61.74,9070,5219050,56.12
2021-07-16,1150,5742141,61.75,5721,5224771,56.18
2021-07-17,297,5742438,61.75,1297,5226068,56.2
2021-07-18,2007,5744445,61.77,9658,5235726,56.3
2021-07-19,3085,5747530,61.81,11120,5246846,56.42
2021-07-20,2530,5750060,61.83,11701,5258547,56.55
2021-07-21,2230,5752290,61.86,11620,5270167,56.67
2021-07-22,1648,5753938,61.88,7511,5277678,56.75
